7 16
9  5  5  5  5  5  5  5  5  5  5  10 21 21 21 21
7  17 17 17 17 19 17 19 17 19 17 6  21 21 21 21 
7  18 18 18 18 20 18 20 18 20 18 16 5  5  5  5
7  1  1  1  1  1  1  1  1  1  1  17 17 17 17 17
7  1  1  1  1  1  1  1  1  1  1  18 18 18 18 18
7  1  1  1  1  1  1  1  1  1  1  1  1  1  1  1
11 8  8  8  8  8  8  8  8  8  8  8  8  8  8  8