10 36
9  5  5  5  5  5  5  5  5  5  5  10 22 22 22 22 9  5  5  5  5  5  5  5  5  5  5  5  5  5  5  5  5  5  5  10
7  17 17 17 17 19 17 19 17 19 17 6  22 22 22 22 7  17 17 19 19 19 19 19 19 19 19 19 19 19 19 19 19 17 17 6
7  18 18 18 18 20 18 20 18 20 18 16 5  5  5  5  15 18 18 20 20 20 20 20 20 20 20 20 20 20 20 20 20 18 18 6
7  1  1  1  1  1  1  1  1  1  1  17 17 17 17 17 17 1  1  1  1  1  1  1  1  1  1  1  1  1  1  1  1  1  1  6
7  1  1  1  1  1  1  1  1  1  1  18 18 18 18 18 18 1  1  1  1  1  1  1  1  1  1  1  1  1  1  1  1  1  1  6
7  1  1  1  1  1  1  1  1  1  1  1  1  1  1  1  1  1  1  1  1  1  1  1  14 8  8  8  8  8  8  8  8  8  8  12
11 8  8  8  8  8  8  8  8  8  8  8  8  8  8  8  13 1  1  1  1  1  1  1  6  21 21 21 21 21 21 21 21 21 21 21
21 21 21 21 21 21 21 21 21 21 21 21 21 21 21 21 7  1  1  1  1  1  1  1  6  21 21 21 21 21 21 21 21 21 21 21
21 21 21 21 21 21 21 21 21 21 21 21 21 21 21 21 7  1  1  1  1  1  1  1  16 5  5  5  5  5  5  5  5  5  5  10
21 21 21 21 21 21 21 21 21 21 21 21 21 21 21 21 7  1  1  1  1  1  1  1  1  1  1  1  1  1  1  1  1  1  1  6