7 15
8  8  8  13 1  1  1  1  1  1  1  14 8  8  8
21 21 21 7  1  1  1  1  1  1  1  6  21 21 21
21 21 21 7  1  1  1  1  1  1  1  6  21 21 21 
21 21 21 7  1  1  1  1  1  1  1  6  21 21 21
21 21 21 11 8  8  8  8  8  8  8  12 21 21 21
21 21 21 21 21 21 21 21 21 21 21 21 21 21 21
21 21 21 21 21 21 21 21 21 21 21 21 21 21 21
