7 16
9  5  5  5  5  5  5  5  5  5  5  10 0  0  0  0
7  17 17 17 17 19 17 19 17 19 17 6  0  0  0  0
7  18 18 18 18 20 18 20 18 20 18 16 5  5  5  5
7  0  0  0  0  0  0  0  0  0  0  17 17 17 17 17
7  0  0  0  0  0  0  0  0  0  0  18 18 18 18 18
7  0  0  0  0  0  0  0  0  0  0  0  0  0  0  0
11 8  8  8  8  8  8  8  8  8  8  8  8  8  8  8